111111111111111
100000000P00011
100001111111111
110001100000011
110101000001011
1110E1010000011
100000100000011
100000000110111
100000000100011
100000011100C11
110110000100011
101010001000111
111110000100011
111111111111111