111111111111111
1000000E0P00011
100001111111111
110001100000011
11C101000001011
111001C10000011
100000100000011
100000000110111
100000000100011
100000011100011
110110000100011
10C010001000111
111110000100C11
111111111111111