11111111111111
100000010P0001
10000110111111
10000110000001
10E0000X000101
100000C0000001
10000000000001
10000000011011
10000000010001
1X000001110001
1000000001X0X1
1000000X010001
11000000010011
11111111111111