1111111111111111111
100000000P000111111
1000011111100000111
1100011001100011101
11E1010000000111111
111001C100001100101
1000001000000000011
1100000101101111111
1111111111111111111