1111111111111
100000000P011
1000011111111
1100011001101
11E1000000011
111001C100011
1000001000001
1100000101101
1111111111111