11111111111111
100000000P0001
10000111111111
11000110000001
11E10100000101
111001C1000001
10000010000001
11000001011011
10000000110001
10010001110001
11011000010001
10C01000100011
11111000010011
11111111111111